FP	SRP
ACA	SPD
M3	KVD
IBA	JVA
ACN	SUG
NAWP	SSK
G&M	SR
EVS	SMR
DS	JK
CNS	VKP
DBMS	VMK
DAA	YBL
FM	INST.FAC
PC	SS
PSQT	SPG
S&V	TRP
GTA	RM
SPOS	APARNA
CO	AAS
CN	JA
STQA	SG
CC	GSN
IS	SBM
IR	UUG
ADBMS	ABP
AP	KM
CONSTITUTION	SD
HCI	SK
DSGT	GS
DSA	AM
TDB	VZA
SP	SNG
DS-Lab	RS
MAN	SKG
